########################################
#......................................#
#........#.............................#
#........#.............................#
#........#.............................#
#........#.............................#
#........#.............................#
#........#.............................#
#........#.............................#
#........#.............................#
#........#.............................#
#........#.............................#
#........#.............................#
#........#.............................#
#........#.............................#
#........#.............................#
#........#.............................#
#........#.............................#
#........#.............................#
#........#.............................#
#........#.............................#
#........#.............................#
#........#.............................#
#........#.............................#
#........#.............................#
#........#.............................#
#........#.............................#
#........#.............................#
#........#.............................#
#........#.............................#
#........#.............................#
#........#.............................#
#........#.............................#
#........#.............................#
#........#.............................#
#........#.............................#
#........#.............................#
#........#########################.....#
#@.....................................x
########################################