########################################
#......................................#
#......................................#
#......................................#
#......................................#
#......................................#
#.####################################.#
#..................#...................#
##################...###################
#..................T...................#
#..................#...................#
#.####################################.#
#.####################################.#
#..................#...................#
##################...###################
#..................T...................#
#..................#...................#
#.####################################.#
#.####################################.#
#..................#...................#
##################...###################
#..................T...................#
#..................#...................#
#.####################################.#
#.####################################.#
#..................#...................#
##################...###################
#..................T...................#
#..................#...................#
#@####################################.#
#.####################################.#
#..................#...................#
##################...###################
#..................T...................#
#..................#...................#
#.####################################.#
#T.....................................#
#......................................#
#...............................T......x
########################################